胖丁
⠀⠀⠀⠀⠀⠀⠀⠀⠀⠀⠀⠀⠀⠀⠀⠀⠀⠀⠀⠀⠀⠀⠀⠀⠀⠀⠀⠀⠀⠀⣀⡀⠀⠀⠀⠀⠀⠀⠀⠀⠀⠀⠀
⠀⠀⠀⠀⠀⠀⠀⠀⠀⠀⠀⠀⠀⠀⠀⠀⠀⠀⠀⠀⠀⠀⠀⠀⠀⠀⣀⣴⠶⠛⠉⠹⣆⠀⠀⠀⠀⠀⠀⠀⠀⠀⠀
⠀⠀⠀⠀⠀⠀⠀⠀⠀⠀⠀⠀⠀⠀⠀⠀⠀⠀⢀⣠⣤⣤⣤⣀⣤⠞⠋⠀⢀⣴⣿⣇⠹⡆⠀⠀⠀⠀⠀⠀⠀⠀⠀
⠀⠀⠀⠀⠀⠀⠀⠀⠀⠀⠀⠀⠀⠀⠀⢀⣴⠾⠛⠉⠁⠀⠈⠉⠙⠳⣦⣤⣿⣿⣿⣿⡄⢿⠀⠀⠀⠀⠀⠀⠀⠀⠀
⠀⠀⠀⠀⠀⠀⠀⠀⠀⠀⠀⠀⠀⠀⣠⡿⠁⠀⠀⠀⠀⠀⠀⠀⠀⠀⠀⠙⢿⣿⣿⣿⡇⢸⡇⠀⠀⠀⠀⠀⠀⠀⠀
⢀⣶⠶⠶⠶⠶⠶⢶⣦⣤⣤⣤⣶⠾⡿⠀⠀⠀⠀⠀⠀⠀⠀⠀⠀⠀⠀⠀⠈⢻⣿⣿⣧⠈⣇⠀⠀⠀⠀⠀⠀⠀⠀
⣼⡇⠀⣰⣶⣤⣤⣤⣤⣄⣈⣉⠙⠒⡷⠀⠀⠀⠀⠀⠀⠀⠀⠀⠀⠀⠀⠀⠀⠀⣿⠛⢿⣀⣿⠀⠀⠀⠀⠀⠀⠀⠀
⢿⡇⠀⢹⣿⣿⣿⣿⣿⣿⣿⠏⠀⠀⠀⠀⠀⠀⠀⠀⠀⠀⠀⠀⠀⠀⠀⠀⠀⠀⣿⠀⠀⠙⢿⣄⠀⠀⠀⠀⠀⠀⠀
⢸⡇⠀⠸⣿⣿⣿⣿⣿⣿⠃⠀⠀⠀⠀⠀⠀⠲⢦⣤⣄⣀⠀⠀⠀⠀⠀⠀⠀⠀⣿⠀⠀⠀⠀⠙⢧⡀⠀⠀⠀⠀⠀
⢸⣇⠀⠀⢻⣿⣿⣿⣿⠃⠀⠀⠀⠀⠀⠀⠀⠀⠀⠀⡟⠙⢷⡄⠀⠀⠀⠀⠀⢀⣿⣶⣿⡿⢷⣄⠈⢿⡄⠀⠀⠀⠀
⠈⣿⠀⠀⠈⢿⣿⣿⠃⠀⠀⠀⠀⣀⣀⣤⣤⣀⡀⠀⣧⠀⠀⠀⠀⠀⠀⠀⢠⡾⢿⣿⣿⡀⠀⢹⣧⠀⢻⡀⠀⠀⠀
⠀⠹⣧⠀⠀⠈⢿⡏⠀⠀⢀⡴⠋⣩⣿⣿⡿⠛⠻⣷⣼⡷⣄⣀⣀⣠⣤⠾⠋⠀⣾⣿⣿⣿⣶⣾⣿⣇⠈⣧⠀⠀⠀
⠀⠀⣿⡆⠀⠀⠀⠀⠀⢠⡟⢠⣾⣿⣿⣟⠀⠀⠀⢸⣿⣷⡀⠉⠉⠁⠀⠀⠀⠀⢻⣿⣿⣿⣿⣿⣿⣿⠀⢿⠟⠛⣷
⠀⠀⣿⠀⠀⠀⠀⠀⠀⣿⠀⣾⣿⣿⣿⣿⣦⣀⣠⣾⣿⡏⢷⠀⠀⠀⠀⠀⠀⠀⠘⣎⠻⣿⣿⣿⣿⣿⠀⢸⠀⣸⠇
⠀⠀⢿⡄⠀⠀⠀⠀⠀⣿⠀⢿⣿⣿⣿⣿⣿⣿⣿⣿⣿⡇⣸⠀⠀⠀⠀⠀⢀⣀⣀⠈⢧⣌⣉⣋⣴⠃⠀⢸⣴⠏⠀
⠀⠀⢸⡇⠀⠀⠀⠀⠀⢹⣆⠘⢿⣿⣿⣿⣿⣿⣿⣿⠟⢠⠏⠀⠀⣰⣶⣿⣿⣿⣿⠀⠀⠈⠉⠉⠀⠀⠀⣿⠃⠀⠀
⠀⠀⠸⣷⠀⠀⠀⠀⠀⠀⠻⣦⡀⠙⠻⠿⠿⠿⠛⢁⣴⠏⠀⠀⠀⢸⡄⠀⠙⢿⣿⠀⠀⠀⠀⠀⠀⠀⢰⡏⠀⠀⠀
⠀⠀⠀⢹⣇⠀⠀⠀⠀⠀⠀⠈⠛⠶⣦⣤⣤⡴⠾⠋⠀⠀⠀⠀⠀⠈⣷⠀⠀⠀⢻⠀⠀⠀⠀⠀⠀⢀⡿⠀⠀⠀⠀
⠀⠀⠀⠀⢻⣦⠀⠀⠀⠀⠀⠀⠀⠀⠀⠀⠀⠀⠦⣤⣀⡀⠀⠀⠀⠀⠸⣧⡀⢀⡿⠀⠀⠀⠀⠀⢠⡾⠁⠀⠀⠀⠀
⠀⠀⠀⠀⠀⠹⣷⡀⠀⠀⠀⠀⠀⠀⠀⠀⠀⠀⠀⠈⠉⠛⠳⢦⡄⠀⠀⠘⠻⠞⠃⠀⠀⠀⠀⣰⠟⠁⠀⠀⠀⠀⠀
⠀⠀⠀⠀⠀⠀⠈⠻⣦⡀⠀⠀⠀⠀⠀⠀⣀⠀⠀⠀⢀⣀⣴⠞⠁⠀⠀⠀⠀⠀⠀⠀⢀⣠⠞⠁⠀⠀⠀⠀⠀⠀⠀
⠀⠀⠀⠀⠀⠀⠀⠀⠈⠛⢷⣤⣀⠀⠀⠀⠙⠛⠛⠛⠋⠉⠀⠀⠀⠀⠀⠀⠀⢀⣠⣴⡟⠁⠀⠀⠀⠀⠀⠀⠀⠀⠀
⠀⠀⠀⠀⠀⠀⠀⠀⠀⠀⠀⠈⠙⠻⣶⣦⣤⣀⣀⣀⣀⣀⣀⣀⣠⣤⣴⣶⠟⠋⠉⠈⠙⠛⢶⣄⡀⠀⠀⠀⠀⠀⠀
⠀⠀⠀⠀⠀⠀⠀⠀⠀⠀⠀⣠⠞⠋⠉⠀⠀⠈⠉⠉⠉⢉⣹⡏⠁⠀⠀⠈⠛⢶⣤⣀⡀⠀⠀⠈⢻⣄⠀⠀⠀⠀⠀
⠀⠀⠀⠀⠀⠀⠀⠀⠀⠀⠘⠿⣦⣤⣤⣤⣤⡴⠶⠶⠛⠋⠁⠀⠀⠀⠀⠀⠀⠀⠀⠉⠛⠛⠷⠶⠶⠟⠀⠀⠀⠀⠀