胖可丁
⠀⠀⠀⠀⠀⠀⠀⠀⠀⠀⠀⠀⠀⠀⠀⠀⠀⠀⠀⠀⠀⠀⠀⠀⠀⠀⠀⠀⠀⠀⠀⠀⠀⠀⠀⠀⠀⠀⠀⠀⠀⠀⠀⠀⠀⠀⠀⠀⠀⠀⠀⢀⣠⡴⠞⢳⡆⠀⠀⠀⠀⠀⠀⠀⠀
⠀⠀⠀⠀⠀⠀⠀⠀⠀⠀⠀⠀⠀⠀⠀⠀⠀⠀⠀⠀⠀⠀⠀⠀⠀⠀⠀⠀⠀⠀⠀⠀⠀⠀⠀⠀⠀⠀⠀⠀⠀⠀⠀⠀⠀⠀⠀⠀⠀⣠⡶⠛⠁⢀⡀⢸⠇⠀⠀⠀⠀⠀⠀⠀⠀
⠀⠀⠀⠀⠀⠀⠀⠀⠀⠀⠀⠀⠀⠀⠀⠀⠀⠀⠀⠀⠀⠀⠀⠀⠀⠀⠀⠀⠀⠀⠀⠀⠀⠀⠀⠀⠀⠀⠀⠀⠀⠀⠀⠀⠀⠀⢀⣠⠞⠉⢀⣤⣾⡿⠁⣾⠀⠀⠀⠀⠀⠀⠀⠀⠀
⢠⣤⣤⡀⠀⠀⠀⠀⠀⠀⠀⠀⠀⠀⠀⠀⠀⠀⠀⠀⠀⠀⠀⠀⠀⠀⠀⠀⠀⠀⠀⠀⠀⠀⠀⠀⠀⠀⠀⠀⠀⠀⠀⠀⢀⣴⠟⠁⢠⣴⣿⣿⣿⠃⣸⠃⠀⠀⠀⠀⠀⠀⠀⠀⠀
⢸⢀⠀⠙⠷⣄⠀⠀⠀⠀⠀⠀⠀⠀⠀⠀⠀⠀⠀⠀⠀⠀⠀⠀⠀⠀⠀⠀⠀⠀⠀⠀⠀⠀⠀⠀⠀⠀⠀⠀⠀⠀⢀⣴⠟⠁⢠⣾⣿⣿⣿⣿⠏⢠⡏⠀⠀⠀⠀⠀⠀⠀⠀⠀⠀
⠸⡇⢹⣦⡀⠈⠳⣄⠀⠀⠀⠀⠀⠀⠀⠀⠀⠀⠀⠀⠀⠀⠀⠀⠀⠀⠀⠀⠀⠀⠀⠀⠀⠀⠀⠀⠀⠀⠀⠀⠀⣰⠟⠁⢀⣴⣿⣿⣿⣿⣿⠏⢠⡟⠀⠀⠀⠀⠀⠀⠀⠀⠀⠀⠀
⠀⢻⡀⢻⣿⣆⠀⠈⢳⣄⠀⠀⠀⠀⠀⠀⠀⠀⠀⠀⠀⠀⠀⠀⠀⠀⠀⠀⠀⠀⠀⠀⠀⠀⠀⠀⠀⠀⠀⣠⡞⠁⠀⣠⣿⣿⣿⣿⣿⣿⠏⢠⡿⠀⠀⠀⠀⠀⠀⠀⠀⠀⠀⠀⠀
⠀⠘⣧⠈⢿⣿⣷⣄⠀⠘⢷⣄⠀⠀⠀⠀⠀⠀⠀⣠⣤⠤⠤⢤⣄⠀⠀⠀⠀⠀⠀⠀⠀⠀⠀⠀⠀⢀⣼⠋⠀⢀⣼⣿⣿⣿⣿⣿⣿⠋⢠⡿⠀⠀⠀⠀⠀⠀⠀⠀⠀⠀⠀⠀⠀
⠀⠀⠸⣆⠘⣿⣿⣿⣦⠀⠀⠙⣷⡀⠀⠀⢀⡴⠛⠁⠀⠀⠀⠀⠈⢳⡄⠀⠀⠀⠀⠀⠀⠀⠀⠀⢠⡿⠁⠀⢠⣾⣿⣿⣿⣿⣿⣿⠃⣰⡟⠀⠀⠀⠀⠀⠀⠀⠀⠀⠀⠀⠀⠀⠀
⠀⠀⠀⢻⡄⠘⣿⣿⣿⣷⣄⠀⠈⠻⣄⢀⡞⠁⠀⠀⠀⢠⡔⠀⠀⢠⡇⠀⠀⠀⠀⠀⠀⠀⠀⢠⡟⠀⠀⢠⣿⣿⣿⣿⣿⣿⡿⠁⣴⠏⠀⠀⠀⠀⠀⠀⠀⠀⠀⠀⠀⠀⠀⠀⠀
⠀⠀⠀⠀⢻⡄⠘⣿⣿⣿⣿⣆⠀⠀⠹⣾⠀⠀⠀⠀⠀⠈⠷⠤⠴⠟⠓⠶⣄⣀⣀⣀⣀⡀⠀⡿⠀⠀⢠⣿⣿⣿⣿⣿⣿⠏⣠⡾⠃⠀⠀⠀⠀⠀⠀⠀⠀⠀⠀⠀⠀⠀⠀⠀⠀
⠀⠀⠀⠀⠀⢻⡄⠙⣿⣿⣿⣿⣧⡀⠀⡇⠀⠀⠀⠀⠀⠀⠀⠀⠀⠀⠀⠀⠘⢿⡉⠉⠉⠉⢙⡇⠀⢀⣿⡿⠟⢹⡿⠟⢡⡴⠏⠀⠀⠀⠀⠀⠀⠀⠀⠀⠀⠀⠀⠀⠀⠀⠀⠀⠀
⠀⠀⠀⠀⠀⠀⠻⣄⠙⢿⣿⣿⣿⣷⡀⣧⠀⠀⠀⠀⠀⠀⠀⠀⠀⠀⠀⠀⠀⠈⣇⠀⠀⠀⠀⠷⠀⠸⠏⠀⢀⣀⣤⠾⠋⠁⠀⠀⠀⠀⠀⠀⠀⠀⠀⠀⠀⠀⠀⠀⠀⠀⠀⠀⠀
⠀⠀⠀⠀⠀⠀⠀⠙⢶⣄⡉⠛⠻⠿⢷⣹⡄⠀⠀⠀⠀⠀⠀⠀⠀⠀⠀⠀⠀⣐⡿⠃⠀⠀⠀⠀⠀⠀⠀⠛⠋⠻⣇⡀⠀⠀⠀⠀⠀⠀⠀⠀⠀⠀⠀⠀⠀⠀⠀⠀⠀⠀⠀⠀⠀
⠀⠀⠀⠀⠀⠀⠀⠀⠀⠈⠙⠲⢤⣀⡈⣻⠻⣆⡀⠀⠀⠀⠀⠀⠀⠀⠀⠀⢂⣼⣃⠤⠖⠲⠤⢄⡀⠀⠀⠀⠀⠀⠈⠳⣆⠀⠀⠀⠀⠀⠀⠀⠀⠀⠀⠀⠀⠀⠀⠀⠀⠀⠀⠀⠀
⠀⠀⠀⠀⠀⠀⠀⠀⠀⠀⠀⠀⠀⠈⢙⡟⢀⡬⠷⢷⣄⡀⠠⠀⠀⣀⣨⡴⢻⠋⡴⠊⢡⠁⠫⠓⣝⢆⠀⠀⠀⠀⠀⠀⠈⢷⣄⠀⠀⠀⠀⠀⠀⠀⠀⠀⠀⠀⠀⠀⠀⠀⠀⠀⠀
⠀⠀⠀⠀⠀⠀⠀⠀⠀⠀⠀⠀⠀⠀⢸⡷⢁⡔⡚⠵⡺⣏⠙⠛⠋⠉⠁⠄⡏⢸⠀⠐⠈⠠⠄⢢⠈⣿⠀⠀⠀⠀⠀⠀⠀⠀⠙⢷⡀⠀⠀⠀⠀⠀⠀⠀⠀⠀⠀⠀⠀⠀⠀⠀⠀
⠀⠀⠀⠀⠀⠀⠀⠀⠀⠀⠀⠀⠀⠀⣿⡃⡎⠀⡁⠀⠃⣽⠀⠀⠀⠀⠀⠀⢳⡘⣄⠈⠄⢁⠀⠂⣴⡟⠀⠀⠀⠀⠀⠀⠀⠀⠀⠀⠻⣦⡀⠀⠀⠀⠀⠀⠀⠀⠀⠀⠀⠀⠀⠀⠀
⠀⠀⠀⠀⠀⠀⠀⠀⠀⠀⠀⠀⠀⠀⣿⢳⣱⡄⢀⠡⣠⠇⢀⠀⠀⠀⠀⠀⠀⠙⠬⣕⣒⣂⣺⠯⠋⠀⠀⠀⠀⠀⠀⠀⠀⠀⠀⠀⠀⠈⠻⣦⡀⠀⠀⠀⠀⠀⠀⠀⠀⠀⠀⠀⠀
⠀⠀⠀⠀⠀⠀⠀⠀⠀⠀⠀⠀⠀⠀⣿⠀⠙⠛⠛⢛⠁⠀⢰⣿⣿⣦⠀⠀⠀⠀⠀⠀⠀⢀⠀⠀⠀⠀⠀⠀⠀⠀⠀⠀⠀⠀⠀⠀⠀⠀⠀⠈⢻⣄⠀⠀⠀⠀⠀⠀⠀⠀⠀⠀⠀
⠀⠀⠀⠀⠀⠀⠀⠀⠀⣀⣀⣀⡀⠀⢸⡂⠀⠀⠀⠀⠀⠀⠘⢿⣥⡼⠃⠀⠀⠀⠀⠀⠀⠀⠀⠂⢀⠀⠀⠀⠀⠀⠀⠀⠀⠀⠀⠀⠀⠀⠀⠀⠀⠙⣷⡀⠀⠀⠀⠀⠀⠀⠀⠀⠀
⠀⠀⠀⠀⠀⠀⠀⠀⣟⠉⠉⠉⠉⠙⢻⡇⠀⠈⠀⠀⠀⠀⠀⠀⠀⠀⠀⠀⠀⠀⠀⠀⠀⠀⠀⠀⠀⣠⡶⠀⠀⠀⠀⠀⠀⠀⠀⠀⠀⠀⠀⠀⠀⠀⠈⣷⡀⠀⠀⠀⠀⠀⠀⠀⠀
⠀⠀⠀⠀⠀⠀⠀⠀⠹⢦⡠⢀⠀⠀⠈⣷⠰⠀⠀⠀⠀⠀⠀⠀⠀⠀⠀⠀⠀⠀⠀⠀⠀⠀⠀⢀⡾⠋⠀⠀⠀⠀⠀⡀⠀⠀⠀⠀⠀⠀⠀⠀⠀⠀⠀⠈⣿⠀⠀⠀⠀⠀⠀⠀⠀
⠀⠀⠀⠀⠀⠀⠀⠀⠀⠀⠙⠷⣤⡀⠠⢹⡇⠀⠀⠀⠀⠀⠀⠀⠀⠀⠀⠀⠀⠀⠀⠀⠀⠀⢠⡟⠁⠀⠀⠀⢀⠀⠀⣰⠀⠀⠀⠀⠀⠀⠀⠀⠀⠀⠀⠀⢸⣇⠀⠀⠀⠀⠀⠀⠀
⠀⠀⠀⠀⠀⠀⠀⠀⠀⠀⠀⠀⠈⠙⠳⢮⣷⠀⠀⠀⠀⠀⠀⠀⠀⠀⠀⠀⠀⠀⠀⠀⠀⠀⣿⠀⠀⠀⠠⣀⣤⡶⠟⠁⠀⠀⠀⠀⠀⠀⠀⠀⠀⠀⠀⠀⠀⣿⠀⠀⠀⠀⠀⠀⠀
⠀⠀⠀⠀⠀⠀⠀⠀⠀⠀⠀⠀⠀⠀⠀⠀⠘⣧⠀⠀⠀⠀⠀⠀⠀⠀⠀⠀⠀⠀⠀⠀⠀⠀⠻⠶⠶⠞⠛⠉⠁⠀⠀⠀⠀⠀⠀⠀⠀⠀⠀⠀⠀⠀⠀⠀⢀⣿⠀⠀⠀⠀⠀⠀⠀
⠀⠀⠀⠀⠀⠀⠀⠀⠀⠀⠀⠀⠀⠀⠀⠀⠀⠹⣧⠀⠀⠀⠀⠀⠀⠀⠀⠀⠀⠀⠀⠀⠀⠀⠀⠀⠀⠀⠀⠀⠀⠀⠀⠀⠀⠀⠀⠀⠀⠀⠀⠀⠀⠀⠀⠀⣸⠇⠀⠀⠀⠀⠀⠀⠀
⠀⠀⠀⠀⠀⠀⠀⠀⠀⠀⠀⠀⠀⠀⠀⠀⠀⠀⠸⣧⠀⠀⠀⠀⠀⠀⠀⠀⠀⠀⠀⠀⠀⠀⠀⠀⠀⠀⠀⠀⠀⠀⠀⠀⠀⠀⠈⠂⠀⠀⠀⠀⠀⠀⠀⣰⡟⠀⠀⠀⠀⠀⠀⠀⠀
⠀⠀⠀⠀⠀⠀⠀⠀⠀⠀⠀⠀⠀⠀⠀⠀⠀⠀⠀⠘⢷⡄⠀⠀⠀⠀⠀⠀⠀⠀⠀⠀⠀⠀⠀⠀⠀⠀⠀⠀⠀⠀⠀⠀⠀⠀⠀⠀⠀⠀⠀⠀⠀⢀⣽⣯⣀⠀⠀⠀⠀⠀⠀⠀⠀
⠀⠀⠀⠀⠀⠀⠀⠀⠀⠀⠀⠀⠀⠀⠀⠀⠀⠀⠀⠀⠈⠻⣦⡀⠀⠀⠀⠀⠀⠀⠀⠀⠀⠀⠀⠀⠀⠀⠀⠀⠀⠀⠀⠀⠀⠀⠀⠀⠀⢀⠄⢂⣴⠟⠃⠀⠈⠛⠳⣤⡀⠀⠀⠀⠀
⠀⠀⠀⠀⠀⠀⠀⠀⠀⠀⠀⠀⠀⠀⠀⠀⠀⠀⠀⠀⠀⠀⠈⠻⢦⣄⠀⠀⠀⠀⠀⠀⠀⠀⠀⠀⠀⠀⠀⠀⠀⠀⠀⠀⠀⠀⠀⠐⢀⣠⡶⠛⢿⡄⠐⠀⠀⠀⠀⠀⠙⠳⣄⠀⠀
⠀⠀⠀⠀⠀⠀⠀⠀⠀⠀⠀⠀⠀⠀⠀⠀⠀⠀⠀⠀⠀⠀⠀⣀⣠⣽⠿⢦⣤⣀⠀⠀⠀⠀⠀⠀⠀⠀⠀⠀⠀⠀⠀⠀⣀⣠⣤⠾⠛⠁⠀⠀⠀⠻⣦⠀⠀⠀⠀⠀⠀⠀⠘⢷⡀
⠀⠀⠀⠀⠀⠀⠀⠀⠀⠀⠀⠀⠀⠀⠀⠀⠀⠀⠀⢀⣠⡴⠛⠉⠁⠀⠀⠀⠈⠉⠛⠻⣶⡶⠦⠤⠤⠤⠤⠴⠶⠶⠛⠛⠉⠁⠀⠀⠀⠀⠀⠀⠀⠀⠈⠳⣄⠀⠀⠀⠀⠀⠀⢸⡇
⠀⠀⠀⠀⠀⠀⠀⠀⠀⠀⠀⠀⠀⠀⠀⠀⠀⢀⡴⠛⠁⠀⠀⠀⠀⠀⠀⠑⢀⣠⡴⠟⠉⠀⠀⠀⠀⠀⠀⠀⠀⠀⠀⠀⠀⠀⠀⠀⠀⠀⠀⠀⠀⠀⠀⠀⠈⠳⣦⣀⣀⢀⣀⣼⠇
⠀⠀⠀⠀⠀⠀⠀⠀⠀⠀⠀⠀⠀⠀⠀⠀⢠⡟⠁⠀⠀⠀⠀⠀⢀⣀⣤⠶⠛⠉⠀⠀⠀⠀⠀⠀⠀⠀⠀⠀⠀⠀⠀⠀⠀⠀⠀⠀⠀⠀⠀⠀⠀⠀⠀⠀⠀⠀⠀⠉⠉⠉⠉⠀⠀
⠀⠀⠀⠀⠀⠀⠀⠀⠀⠀⠀⠀⠀⠀⠀⠀⠀⠙⠶⠶⠶⠶⠶⠟⠋⠉⠀⠀⠀⠀⠀⠀⠀⠀⠀⠀⠀⠀⠀⠀⠀⠀⠀⠀⠀⠀⠀⠀⠀⠀⠀⠀⠀⠀⠀⠀⠀⠀⠀⠀⠀⠀⠀⠀⠀