地鼠
⠀⠀⠀⠀⠀⠀⠀⠀⠀⠀⠀⠀⠀⠀⠀⠀⠀⠀⠀⠀⠀⠀⠀⠀⠀⢀⣀⣤⣴⣶⣶⣶⠿⠿⠿⠷⣶⣶⣦⣤⣄⡀⠀⠀⠀⠀⠀⠀⠀⠀⠀⠀⠀⠀⠀⠀⠀⠀⠀⠀⠀⠀⠀⠀⠀
⠀⠀⠀⠀⠀⠀⠀⠀⠀⠀⠀⠀⠀⠀⠀⠀⠀⠀⠀⠀⠀⠀⠀⣠⣶⣿⠟⠛⠉⠁⠀⠀⠀⠀⠀⠀⠀⠀⠉⠛⠻⢿⣶⣄⠀⠀⠀⠀⠀⠀⠀⠀⠀⠀⠀⠀⠀⠀⠀⠀⠀⠀⠀⠀⠀
⠀⠀⠀⠀⠀⠀⠀⠀⠀⠀⠀⠀⠀⠀⠀⠀⠀⠀⠀⠀⣠⣠⣾⠟⠋⠀⠀⠀⠀⠀⠀⠀⠀⠀⠀⠀⠀⠀⠀⠀⠀⠀⠙⠻⣿⣦⡀⠀⠀⠀⠀⠀⠀⠀⠀⠀⠀⠀⠀⠀⠀⠀⠀⠀⠀
⠀⠀⠀⠀⠀⠀⠀⠀⠀⠀⠀⠀⠀⠀⠀⠀⠀⠀⠀⣾⣿⡟⠁⠀⠀⠀⢀⡞⢻⡆⠀⠀⠀⠀⠀⠀⠀⣰⡟⣷⠀⠀⠀⠀⠈⠻⣷⣆⠀⠀⠀⠀⠀⠀⠀⠀⠀⠀⠀⠀⠀⠀⠀⠀⠀
⠀⠀⠀⠀⠀⠀⠀⠀⠀⠀⠀⠀⠀⠀⠀⠀⠀⢠⣾⣿⠏⠀⠀⠀⠀⠀⢸⣿⣾⡇⠀⠀⠀⠀⠀⠀⠀⣿⣷⣿⠀⠀⠀⠀⠀⡄⠙⣿⣆⠀⠀⠀⠀⠀⠀⠀⠀⠀⠀⠀⠀⠀⠀⠀⠀
⠀⠀⠀⠀⠀⠀⠀⠀⠀⠀⠀⠀⠀⠀⠀⠀⠀⢰⣿⠏⠀⠀⠀⠀⠀⠀⠘⣿⣿⡇⠀⠀⠀⠀⠀⠀⠀⢻⣿⣿⠀⠀⠀⠀⠀⠀⠀⠘⣿⣇⠀⠀⠀⠀⠀⠀⠀⠀⠀⠀⠀⠀⠀⠀⠀
⠀⠀⠀⠀⠀⠀⠀⠀⠀⠀⠀⠀⠀⠀⠀⠀⠀⣿⡟⠀⠀⠀⠀⠀⠀⠀⠀⠙⠋⣀⣀⣠⣤⣤⣤⣄⣀⡈⠛⠁⠀⠀⠀⠀⠀⠀⠀⠀⢹⣿⡄⠀⠀⠀⠀⠀⠀⠀⠀⠀⠀⠀⠀⠀⠀
⠀⠀⠀⠀⠀⠀⠀⠀⠀⠀⠀⠀⠀⠀⠀⠀⢠⣿⡇⠀⠀⠀⠀⠀⠀⠀⠀⣠⣾⠟⠋⠉⠉⣻⠙⠛⠛⠻⢷⡄⠀⠀⠀⠀⠀⠀⠀⠀⠘⣿⡇⠀⠀⠀⠀⠀⠀⠀⠀⠀⠀⠀⠀⠀⠀
⠀⠀⠀⠀⠀⠀⠀⠀⠀⠀⠀⠀⠀⠀⠀⠀⢸⣿⠁⠀⠀⠀⠀⠀⠀⠀⠀⢿⣏⡓⢒⣞⡛⠄⠀⠀⠀⢀⣼⡟⠀⠀⠀⠀⠀⠀⠀⠀⠀⣿⡇⠀⠀⠀⠀⠀⠀⠀⠀⠀⠀⠀⠀⠀⠀
⠀⠀⠀⠀⠀⠀⠀⠀⠀⠀⠀⠀⠀⠀⠀⠀⢸⣿⠀⠀⠀⠀⠀⠀⠀⠀⠀⠀⠙⠻⠿⠶⣶⣶⡶⠶⠿⠛⠁⠀⠀⠀⠀⢀⡄⠀⠀⠀⠀⣿⡇⠀⠀⠀⠀⠀⠀⠀⠀⠀⠀⠀⠀⠀⠀
⠀⠀⠀⠀⠀⠀⠀⠀⠀⠀⠀⠀⠀⠀⠀⠀⢸⣿⠀⠀⠀⠀⠀⠀⠀⠀⠀⠀⠀⠀⠀⠀⠀⠀⠀⠀⠀⠀⠀⠀⠀⠀⠀⣼⠀⠀⠀⠀⠀⣿⡇⠀⠀⠀⠀⠀⠀⠀⠀⠀⠀⠀⠀⠀⠀
⠀⠀⠀⠀⠀⠀⠀⠀⠀⠀⠀⠀⠀⠀⠀⢀⣸⣿⠀⠀⠀⠀⠀⠀⠀⠀⠀⠀⠀⠀⠀⠀⠀⠀⠀⠀⠀⠀⠀⠀⠀⠀⣰⠃⠀⠀⠀⠀⠀⣿⡇⠀⠀⠀⠀⠀⠀⠀⠀⠀⠀⠀⠀⠀⠀
⠀⠀⠀⠀⠀⠀⠀⠀⠀⠀⠀⣠⡾⠿⠛⠛⢻⣿⠀⠀⠀⠀⠀⠀⠀⠀⠀⠀⠀⠀⠀⠀⠀⠀⠀⠀⠀⠀⠀⠀⠀⣠⠇⠀⠀⠀⠀⠀⠀⣿⡧⠀⠀⠀⠀⠀⠀⠀⠀⠀⠀⠀⠀⠀⠀
⠀⠀⠀⠀⠀⠀⢀⣤⣶⡾⠟⠋⣀⣀⠀⠀⢸⡟⠀⠀⠀⠀⠀⠀⠀⠀⠀⠀⠀⠀⠀⠀⠀⠀⠀⠀⠀⠀⠀⠀⡰⠃⠀⠀⠀⠀⠀⠀⠀⣿⡿⠾⠿⢿⣶⣦⡀⠀⠀⠀⠀⠀⠀⠀⠀
⠀⠀⠀⠀⠀⣠⣿⠋⢀⣠⣴⠿⠛⠛⠻⢷⣾⡇⠀⠀⠀⠀⠀⠀⠀⠀⠀⠀⠀⠀⠀⠀⠀⠀⠀⠀⠀⠀⢀⡞⠁⠀⠀⠀⠀⠀⠀⠀⠀⣿⡇⠀⠀⠀⠈⠛⢿⣦⣀⡀⠀⠀⠀⠀⠀
⠀⠀⣠⣶⡿⣫⣵⡾⠛⠉⠀⠀⠀⠀⠀⠀⣹⣇⠀⣀⣤⣤⣤⣄⣀⣀⠀⠀⠀⠀⠀⠀⠀⠀⠀⠀⢀⡴⠯⠀⠀⠀⠀⠀⠀⠀⠀⠀⠀⣿⣇⣴⣤⣤⣀⡀⠀⠉⠛⢻⡆⠀⠀⠀⠀
⢠⣾⠟⠁⢰⣿⠃⠀⠀⠀⠀⠀⢀⣤⣶⠟⠛⠻⡿⠟⠉⠈⠁⠈⠉⢿⣷⡀⠀⠀⠀⠀⠀⠀⢀⡴⣻⣾⠿⠿⢿⠿⠿⣷⣀⣤⣶⣶⡾⠿⠟⠁⠀⠈⢻⣿⣦⡀⠀⠘⢿⣶⣄⡀⠀
⢻⣧⠀⠀⠛⠃⠀⠀⠀⠀⢀⣶⡿⠋⠀⠀⠀⠀⢠⠀⠀⠀⠀⠀⠀⠀⠙⠻⠷⠶⠟⠛⢿⣶⣵⡾⠟⠁⠀⠀⠈⣇⠀⠙⢿⣯⣄⡀⠀⠀⠀⠀⠀⠀⠀⠉⠛⠿⣶⡄⠀⠈⠙⢿⣦
⠘⣿⣧⡀⠀⠀⠀⢀⣤⣶⡿⠋⠀⠀⠀⠀⠀⠀⢸⠀⠀⠀⠀⠀⠀⠀⠀⠀⠀⠀⠀⠀⠀⣹⡟⠁⠀⠀⠀⠀⠀⠈⢣⡀⠀⠈⠙⢿⡆⠀⠀⠀⠀⠀⠀⠀⠀⠀⠀⠀⠀⠀⠀⠀⣿
⠀⠈⠻⣷⣄⠀⠀⡜⠋⠀⠀⠀⠀⠀⠀⠀⠀⠀⢸⠀⠀⠀⠀⠀⠀⠀⠀⠀⠀⠀⠀⠀⠀⢿⠇⠀⠀⠀⠀⠀⠀⠀⠀⠙⢄⠀⠀⠸⠇⠀⠀⠀⠀⠀⠀⠀⠀⠀⠀⠀⠀⠀⠀⢀⣿
⠀⠀⠀⠙⣿⡀⣸⠀⠀⠀⠀⠀⠀⠀⠀⠀⠀⠀⢸⠀⠀⠀⠀⠀⠀⠀⠀⠀⠀⠀⢀⡀⠀⠰⡄⠀⠀⠀⠀⠀⠀⠀⠀⠀⠘⠆⠀⠀⠀⠀⠀⠀⠀⠀⠀⠀⠀⠀⠀⠀⢀⣠⣶⡿⠋
⠀⠀⠀⠀⢻⣧⠁⠀⠀⠀⠀⠀⠀⠀⠀⠀⠀⠀⢸⠀⠀⠀⠀⠀⠀⠀⠀⠀⢀⠖⠁⠀⠀⠀⢣⠀⠀⠀⠀⠀⠀⠀⠀⠀⠀⠀⠀⠀⠀⠀⠀⠀⠀⠀⠀⠀⠀⠀⢀⣴⡿⠛⠉⠀⠀
⠀⠀⠀⠀⠀⠛⢿⣶⣤⣀⠀⠀⠀⠀⠀⣀⣠⣴⣾⣶⣄⡀⠀⠀⠀⠀⠀⢀⠎⠀⠀⠀⠀⠀⠈⣆⠀⠀⠀⠀⠀⠀⠀⠀⠀⡀⠀⠀⠀⠀⠀⣠⣿⠶⢶⣶⣶⣾⡿⠋⠀⠀⠀⠀⠀
⠀⠀⠀⠀⠀⠀⠀⠈⠙⠻⢷⣦⣤⣶⡿⠟⠛⠉⠀⠈⠙⢿⣇⠀⠀⠀⢠⠋⠀⠀⠀⠀⠀⠀⠀⣸⣄⣀⣀⣀⣀⣀⠀⠀⠀⠹⠀⠀⢀⣤⣾⠟⠁⠀⠀⠀⠀⠀⠀⠀⠀⠀⠀⠀⠀
⠀⠀⠀⠀⠀⠀⠀⠀⠀⠀⠀⠉⠋⠁⠀⠀⠀⠀⠀⠀⠀⠘⣿⣆⠀⢠⠎⠀⠀⠀⠀⠀⠀⢀⣼⡿⠛⠛⠛⠛⠛⠛⢿⣶⣄⣀⣠⣴⣿⠟⠁⠀⠀⠀⠀⠀⠀⠀⠀⠀⠀⠀⠀⠀⠀
⠀⠀⠀⠀⠀⠀⠀⠀⠀⠀⠀⠀⠀⠀⠀⠀⠀⠀⠀⠀⠀⠀⠸⣿⡿⠾⢶⣦⣤⣤⣤⣤⣴⡿⡛⠀⠀⠀⠀⠀⠀⠀⠀⠈⠙⢻⡛⠋⠁⠀⠀⠀⠀⠀⠀⠀⠀⠀⠀⠀⠀⠀⠀⠀⠀