大钳蟹
⠀⠀⠀⣠⡴⠞⠛⠛⠛⠒⠲⠶⠶⣤⣀⡀⠀⠀⠀⠀⠀⠀⠀⠀⠀⠀⠀⠀⠀⠀⠀⠀⠀⠀⠀⠀⠀⠀⠀⠀⠀⠀⠀⠀⠀⠀⠀⠀⠀⠀⠀⠀⠀⠀⠀⠀⠀⠀⠀⠀⠀⠀⠀⠀⠀
⠀⣠⠞⠋⠀⠀⠀⠀⠀⠀⠀⠀⠀⠀⠈⠙⠛⢦⡀⠀⠀⠀⠀⠀⠀⠀⠀⠀⠀⠀⠀⠀⠀⠀⣠⡀⠀⠀⠀⣼⢳⡀⠀⠀⠀⠀⠀⠀⠀⠀⠀⠀⠀⠀⠀⠀⠀⠀⠀⠀⠀⠀⠀⠀⠀
⡼⠋⠀⠀⠀⠀⠀⠀⠀⠀⠀⠀⠀⠀⠀⠀⠀⠈⢻⡄⠀⠀⠀⠀⠀⠀⠀⠀⠀⠀⠀⠀⠀⢰⠋⣧⠀⠀⢰⠇⠸⣇⠀⠀⠀⠀⠀⠀⠀⠀⠀⠀⠀⠀⠀⠀⠀⠀⠀⠀⠀⠀⠀⠀⠀
⢧⠀⠀⠀⢀⣴⣾⣿⣷⣶⣤⡀⠀⠀⠀⠀⠀⠀⠈⢷⠀⠀⠀⠀⠀⠀⠀⠀⠀⠀⠀⠀⠀⣸⠀⠹⡄⢀⡟⠀⠀⢻⡄⠀⠀⠀⠀⠀⠀⠀⠀⠀⠀⠀⠀⠀⠀⠀⠀⠀⠀⠀⠀⠀⠀
⢸⡆⠀⣠⠟⠉⠉⠉⠻⣿⣿⣿⣦⠀⠀⠀⠀⠀⠀⣸⡇⠀⠀⠀⠀⠀⠀⠀⠀⠀⠀⠀⣠⡿⠀⠀⠛⢛⣠⣤⣤⡀⠙⢦⣄⠀⠀⠀⠀⠀⠀⠀⠀⠀⠀⠀⠀⠀⠀⠀⠀⠀⠀⠀⠀
⠀⢻⣶⡏⠀⠀⠀⢀⡀⠘⢿⣿⣿⡄⠀⠀⠀⢀⠔⠁⣇⠀⠀⠀⠀⠀⠀⠀⢠⠖⠲⣾⠉⠀⠀⠀⣴⠋⠁⠀⡈⢹⣆⣠⠬⠝⠶⣤⡀⠀⠀⠀⣠⠶⢶⣶⣄⠀⠀⠀⠀⠀⠀⠀⠀
⠀⠀⠉⠀⠀⠀⠀⢸⠻⢦⣈⣿⣿⣷⡀⠴⠒⠁⠀⣸⡏⢷⠀⣰⣶⠲⢦⣾⢻⡀⠀⡜⡆⠀⠀⢰⡇⠀⠀⠀⣁⣴⠟⠁⠀⠀⠀⠈⣷⠀⣠⡾⢋⣠⡴⢿⣈⠳⢦⡀⠀⠀⠀⠀⠀
⠀⠀⠀⠀⠀⠀⠀⠘⢦⡀⠀⠀⠀⠀⠙⡳⠶⠴⢾⡟⠀⡼⣦⣏⣻⡶⢤⣿⣨⣿⠲⠤⠇⠀⠀⠈⠓⠒⢚⣛⣻⢧⣀⠀⠀⠀⠀⡰⢸⡟⢉⣴⣛⣠⡤⣶⣽⣶⡄⠙⢶⣤⣤⡀⠀
⠀⠀⠀⠀⠀⠀⠀⠀⠈⢻⣄⠀⠀⠐⠉⠀⢀⣴⠯⢤⡾⣇⡈⠙⢿⣶⠶⣾⣿⢻⣶⣄⠀⠀⢀⡤⠶⠛⠉⢉⡟⠈⡏⠙⡲⣦⣸⣷⣼⠉⣉⣉⣋⣤⠤⢿⡀⠻⣟⠦⣴⣣⠖⠉⠀
⠀⠀⠀⠀⠀⠀⠀⠀⠀⠀⠙⠓⠒⠒⠛⠛⠋⠁⠀⢸⠇⢸⡟⢶⣾⡷⠖⠿⣿⣚⡀⠈⠳⣴⠋⠀⠀⠀⠀⠈⠓⣢⢕⣊⠁⠈⢿⣧⣌⠻⢯⣀⠀⠀⠀⠀⠹⣦⠈⢷⡌⠁⠀⠀⠀
⠀⠀⠀⠀⠀⠀⠀⠀⠀⠀⠀⠀⠀⠀⠀⠀⠀⠀⢠⡏⠀⣿⣇⣸⠃⠀⠀⠀⠹⣎⠻⣟⠀⠀⠀⠀⠀⢀⣠⠖⠛⠉⠉⠉⢙⡷⠛⠁⠈⠙⢦⣨⣿⡦⠀⠀⠀⠘⣷⠀⢙⣷⣤⢤⡀
⠀⠀⠀⠀⠀⠀⠀⠀⠀⠀⠀⠀⠀⠀⠀⠀⠀⠀⣞⠀⢰⡷⠿⠟⠀⠀⠀⠀⠀⠈⠛⠺⠿⠶⣤⣄⣀⣾⣁⡀⣀⣀⣠⡴⠟⠁⠀⠀⠀⠀⠀⡟⠀⡿⠀⠀⠀⠀⠘⠧⣯⣀⣤⠶⠛
⠀⠀⠀⠀⠀⠀⠀⠀⠀⠀⠀⠀⠀⠀⠀⠀⡴⣛⣉⣻⡏⠀⠀⠀⠀⠀⠀⠀⠀⠀⠀⠀⠀⠀⠀⠀⠀⠀⠉⠉⠋⠉⠁⠀⠀⠀⠀⠀⠀⣀⣼⣃⢰⠇⠀⠀⠀⠀⠀⠀⠀⠉⠀⠀⠀
⠀⠀⠀⠀⠀⠀⠀⠀⠀⠀⠀⠀⠀⠀⠀⠀⠛⠁⠀⠀⠀⠀⠀⠀⠀⠀⠀⠀⠀⠀⠀⠀⠀⠀⠀⠀⠀⠀⠀⠀⣀⣤⡤⠶⠶⠒⠛⠛⠛⠳⣤⣌⠻⣄⠀⠀⠀⠀⠀⠀⠀⠀⠀⠀⠀
⠀⠀⠀⠀⠀⠀⠀⠀⠀⠀⠀⠀⠀⠀⠀⠀⠀⠀⠀⠀⠀⠀⠀⠀⠀⠀⠀⠀⠀⠀⠀⠀⠀⠀⠀⠀⠀⠀⢀⡾⠋⠀⠀⠀⠀⠀⠀⠀⠀⠀⠎⠻⣇⣻⠀⠀⠀⠀⠀⠀⠀⠀⠀⠀⠀
⠀⠀⠀⠀⠀⠀⠀⠀⠀⠀⠀⠀⠀⠀⠀⠀⠀⠀⠀⠀⠀⠀⠀⠀⠀⠀⠀⠀⠀⠀⠀⠀⠀⠀⠀⠀⠀⣰⠟⠁⠀⠀⠀⠀⠀⠀⠀⠀⠀⠀⠇⠀⢹⡟⠀⠀⠀⠀⠀⠀⠀⠀⠀⠀⠀
⠀⠀⠀⠀⠀⠀⠀⠀⠀⠀⠀⠀⠀⠀⠀⠀⠀⠀⠀⠀⠀⠀⠀⠀⠀⠀⠀⠀⠀⠀⠀⠀⠀⠀⠀⠀⣼⠋⠀⠀⠀⠀⠀⠀⠀⡀⠀⠀⠀⠀⠀⠀⣾⣧⠀⠀⠀⠀⠀⠀⠀⠀⠀⠀⠀
⠀⠀⠀⠀⠀⠀⠀⠀⠀⠀⠀⠀⠀⠀⠀⠀⠀⠀⠀⠀⠀⠀⠀⠀⠀⠀⠀⠀⠀⠀⠀⠀⠀⠀⢀⣾⠃⠀⠀⠀⠀⠀⡠⠖⠉⠀⣀⣠⣤⣤⣴⠾⠁⢻⠀⠀⠀⠀⠀⠀⠀⠀⠀⠀⠀
⠀⠀⠀⠀⠀⠀⠀⠀⠀⠀⠀⠀⠀⠀⠀⠀⠀⠀⠀⠀⠀⠀⠀⠀⠀⠀⠀⠀⠀⠀⠀⠀⠀⠀⣾⠁⠀⠀⠀⢀⡴⠋⠀⢀⡴⠞⢻⣿⣿⣿⠃⢘⠀⢸⡄⠀⠀⠀⠀⠀⠀⠀⠀⠀⠀
⠀⠀⠀⠀⠀⠀⠀⠀⠀⠀⠀⠀⠀⠀⠀⠀⠀⠀⠀⠀⠀⠀⠀⠀⠀⠀⠀⠀⠀⠀⠀⠀⠀⢰⡇⠀⠀⠀⢠⠊⠀⣠⡾⠋⠀⣀⣸⣿⣿⠏⣠⠋⣰⠟⠀⠀⠀⠀⠀⠀⠀⠀⠀⠀⠀
⠀⠀⠀⠀⠀⠀⠀⠀⠀⠀⠀⠀⠀⠀⠀⠀⠀⠀⠀⠀⠀⠀⠀⠀⠀⠀⠀⠀⠀⠀⠀⠀⠀⠈⣧⠀⢀⡔⠁⠀⢸⠋⠀⠀⠀⢻⣍⣩⣔⣊⣁⡾⠋⠀⠀⠀⠀⠀⠀⠀⠀⠀⠀⠀⠀
⠀⠀⠀⠀⠀⠀⠀⠀⠀⠀⠀⠀⠀⠀⠀⠀⠀⠀⠀⠀⠀⠀⠀⠀⠀⠀⠀⠀⠀⠀⠀⠀⠀⠀⠙⣧⠉⠀⠀⠀⢸⠀⠀⠀⠀⠀⠉⠉⠉⠉⠉⠀⠀⠀⠀⠀⠀⠀⠀⠀⠀⠀⠀⠀⠀
⠀⠀⠀⠀⠀⠀⠀⠀⠀⠀⠀⠀⠀⠀⠀⠀⠀⠀⠀⠀⠀⠀⠀⠀⠀⠀⠀⠀⠀⠀⠀⠀⠀⠀⠀⠘⠻⣦⣄⣀⣸⡄⠀⠀⠀⠀⠀⠀⠀⠀⠀⠀⠀⠀⠀⠀⠀⠀⠀⠀⠀⠀⠀⠀⠀